WWWWWWWWWWWWWWWWWWWWWWWWW
WWWW       WW         WWW
W                       W
W                       W
W                       W
W                       W
W                      WW
W   WWWWWWWWW          WW
W        WWWWW         WW
W       WWWWWWW        WW
W       WWWWWWWW      WWW
WWWWWWWWWWWWWWWWWWWWWWWWW
WWWWWWWWWWWWWWWWWWWWWWWWW
